11111111111111111111
10000000000000000001
1P0000000000C0000001
100000C0000000000001
10000000000000000001
1000000C000000000001
10000000000000000001
1E000000000000000001
11111111111111111111
