11111111111
100P1000011
1010000C001
1000E001001
11111111111